%%%%%%%%%%%%%%%%%%%%
%oG  %  G     %% G %
% %% % %%%%%% %% % %
% %     G   G    % %
% % %% %%  %% %% % %
%       G  G   G % %
% % %% %%%%%% %% % %
% %  P P P P P P % %
% %% % %%%%%% % %% %
%G   %PPPPPPPP%    %
%%%%%%%%%%%%%%%%%%%%